......................................................................@............................................................................|
............................................................@...^.....v......................................................................@.....|
.................................^^^....................@.......@...................@@@...............@...........vvvvv.....vvvv.........@@@@@.....|
........................^........@@@.....vvv.........@..........@...................vvv...............v..................^^...........@@@@@@@@.....|
.S..^.....^^.......@@@@@@@@@@@....................@^^^^^^^^^@........^@.......^^^.........^...^...^.........@@@@@@@@@@@@@@@@@@@@@@@@@@@@@@@@@@@@@@@|
.@@@@@@@@@@@@@@@@@@@@@@@@@@@@@@@@@@@@@@@@@@@@@@@@@@@@@@@@@@@@@@@@@@@@@@@@@@@@@@@@@@@@@@@@@@@@@@@@@@@@@@@@@@@@@@@@@@@@@@@@@@@@@@@@@@@@@@@@@@@@@@@@@@|
...................................................................................................................................................|
...................................................................................................................................................|