djvi-dry-out.mp3
...............................................................vvv.........................<@............................@@.....@@.....@@...........|
...............................@@...............@@.........................................<@............................vv.....vv.....vv...........|
.................J.............vv...............vv.........@@@..................<@.........<@.............@@@@@@..............................@@....|
............@@@@@@...@@@@@..............................@@@....@@@.D.@@@..@@@........................@@@.........D............................vv....|
.S....@@@@@@@@@@@@^^^@@@@@@@.........^^....^^........@@@.........^^^^^^^^^^^^@......^...J.......@@@^^^^^^^^^^^^^^^^......^^.....^^.....^^...........|