..............................................^^............................................................................................................|
.............................................<@@...................@.....^....v......................................................................@......|
.....................................^^^.....<@@...............@.........@...................@@@...............@...........vvvvv.....vvvv.........@@@@@.....|
............................^........@@@......vv...........@.............@...................vvv...............v..................^^...........@@@@@@@@.....|
.S......^.....^^.......<@@@@@@@@@@.....................@^^^^^^^^^^^@.........^@.......^^^.........^...^...^.........@@@@@@@@@@@@@@@@@@@@@@@@@@@@@@@@@@@@@@..|
@@@@@@@@@@@@@@@@@@@@@@@@@@@@@@@@@@@@@@@@@@@@@@@@@@@@@@@@@@@@@@@@@@@@@@@@@@@@@@@@@@@@@@@@@@@@@@@@@@@@@@@@@@@@@@@@@@@@@@@@@@@@@@@@@@@@@@@@@@@@@@@@@@@@@@@@@@@@|