djvi-back-on-track.mp3
.................................................................................................................................<@.....................|
....................vv.....................................................................................................@@@..........................|
................................................@@@@@...D..........<@.........<@........................................@@@...@@@@@@....................|
...............@@@................@@@@@@...@@@@@@@@@@......@@@@@...............................@@@@@...@@@...@@@...@@@..................@@@@@...........|
.S.......^@@@^^@@@........^^@@@@@@@@@@@@^^^@@@@@@@@@@^^^^^^@@@@@@@@.......^^........@@@@^^^@@@@@@@@@^^^^^^^^^^^^^^^^^^^^^^^^^^^^^^^^^^^^^^^^^^^^........|