
@.^............................|
@.v............................|
@...........................@@@|
@.......................@@@@@@@|
@.^.................@@@@@@@@...|
@.v......D.......^@@@@.........|
@............^@@@@@@@@.........|
@..S..J.@@@@@@@@@@@@...........|