
@.^............................|
@.v............................|
@.......................@@@@@@@|
@.......................@@@@@@@|
@.^.................@@@@@@@@...|
@.v...............@@@@.........|
@..@..........@@@@@@@@.........|
@..S..J.^^@@@@@@@@@@@@.........|